{
    "tileset" : "assets/tilesets/tiles-dev.json",
    "gridsize" : 16,
    "musicId" : 3,
    "rooms": [
        {
            "id" : 0,
            "x" : 0,
            "y" : 0,
            "width" : 30,
            "height" : 15,
            "cameraBounds" : {
                "x" : 0,
                "y" : 0,
                "width" : 30,
                "height" : 15
            },
            "tile" : [
                1,1,1,1,1,1,1,1,1,1,1,1,1,1,1,1,1,1,1,1,1,1,1,1,1,1,1,1,1,1,
                1,0,0,0,0,0,0,0,0,0,0,0,0,0,0,0,0,0,0,0,0,0,0,0,0,0,0,0,0,1,
                1,0,0,0,0,0,0,0,0,0,0,0,0,0,0,0,0,0,0,0,0,0,0,0,0,0,0,0,0,1,
                1,0,0,0,0,0,0,0,0,0,0,0,0,0,0,0,0,0,0,0,0,0,0,0,0,0,0,0,0,1,
                1,0,0,0,0,0,0,0,0,0,0,0,0,0,0,0,0,0,0,0,0,0,0,0,0,0,0,0,0,1,
                1,0,0,0,0,0,0,0,0,0,1,3,1,0,0,1,1,1,1,0,0,0,0,0,0,0,0,0,0,1,
                1,0,0,0,0,0,0,0,0,0,1,3,1,0,0,1,1,1,1,0,0,0,0,0,0,0,0,0,0,1,
                1,0,0,0,0,0,0,0,0,0,1,3,0,0,0,0,0,0,1,0,0,0,0,0,0,0,0,0,0,1,
                1,0,0,0,0,0,0,0,0,0,1,0,0,0,0,0,0,0,1,0,0,0,0,0,0,0,0,0,0,1,
                1,0,0,0,0,0,0,0,3,0,1,0,0,0,0,0,0,0,1,0,0,0,0,0,0,0,0,0,0,1,
                1,0,0,0,0,0,0,0,3,0,1,0,1,1,1,0,0,0,1,0,0,0,0,0,0,0,0,0,0,1,
                1,0,0,0,3,0,3,0,3,0,0,0,0,0,0,0,0,1,1,0,0,0,0,0,0,0,0,0,0,1,
                1,0,0,0,3,0,3,0,3,0,0,0,0,0,0,0,0,0,0,0,0,0,0,0,0,0,0,0,0,1,
                1,0,0,0,3,0,3,0,3,0,0,0,0,0,0,0,0,0,0,0,0,0,0,0,0,0,0,0,0,1,
                1,1,1,1,1,1,1,1,1,1,1,1,1,1,1,1,1,1,1,1,1,1,1,1,1,1,1,1,1,1
            ],
            "attr" : [
                1,1,1,1,1,1,1,1,1,1,1,1,1,1,1,1,1,1,1,1,1,1,1,1,1,1,1,1,1,1,
                1,0,0,0,0,0,0,0,0,0,0,0,0,0,0,0,0,0,0,0,0,0,0,0,0,0,0,0,0,1,
                1,0,0,0,0,0,0,0,0,0,0,0,0,0,0,0,0,0,0,0,0,0,0,0,0,0,0,0,0,1,
                1,0,0,0,0,0,0,0,0,0,0,0,0,0,0,0,0,0,0,0,0,0,0,0,0,0,0,0,0,1,
                1,0,0,0,0,0,0,0,0,0,0,0,0,0,0,0,0,0,0,0,0,0,0,0,0,0,0,0,0,1,
                1,0,0,0,0,0,0,0,0,0,1,6,1,0,0,1,1,1,1,0,0,0,0,0,0,0,0,0,0,1,
                1,0,0,0,0,0,0,0,0,0,1,2,1,0,0,1,1,1,1,0,0,0,0,0,0,0,0,0,0,1,
                1,0,0,0,0,0,0,0,0,0,1,2,0,0,0,0,0,0,1,0,0,0,0,0,0,0,0,0,0,1,
                1,0,0,0,0,0,0,0,0,0,1,0,0,0,0,0,0,0,1,0,0,0,0,0,0,0,0,0,0,1,
                1,0,0,0,0,0,0,0,6,0,1,0,0,0,0,0,0,0,1,0,0,0,0,0,0,0,0,0,0,1,
                1,0,0,0,0,0,0,0,2,0,1,0,1,1,1,0,0,0,1,0,0,0,0,0,0,0,0,0,0,1,
                1,0,0,0,6,0,6,0,2,0,0,0,0,0,0,0,0,1,1,0,0,0,0,0,0,0,0,0,0,1,
                1,0,0,0,2,0,2,0,2,0,0,0,0,0,0,0,0,0,0,0,0,0,0,0,0,0,0,0,0,1,
                1,0,0,0,2,0,2,0,2,0,0,0,0,0,0,0,0,0,0,0,0,0,0,0,0,0,0,0,0,1,
                1,1,1,1,1,1,1,1,1,1,1,1,1,1,1,1,1,1,1,1,1,1,1,1,1,1,1,1,1,1
            ],
            "enemies" : [
                {
                    "type" : "Telly",
                    "x" : 32,
                    "y" : 36,
                    "direction" : "Left"
                },
                {
                    "type" : "Telly",
                    "x" : 100,
                    "y" : 64,
                    "direction" : "Right"
                }
            ],
            "items" : [],
            "transitions" : []
        }
    ]
}