{
	"tileset" : "assets/tilesets/tiles-spark.json",
	"gridsize" : 16,
	"musicId" : 5,
	"rooms": [
		{
			"id" : 0,
			"x" : 0,
			"y" : 0,
			"width" : 20,
			"height" : 15,
			"cameraBounds" : {
				"x" : 0,
				"y" : 0,
				"width" : 30,
				"height" : 15
			},
			"tile" : [
				0,0,0,0,0,0,0,0,0,0,0,0,0,0,0,0,0,0,0,0,
				0,0,0,0,0,0,0,0,0,0,0,0,0,0,0,0,0,0,0,0,
				0,0,0,0,0,0,0,0,0,0,0,0,0,0,0,0,0,0,0,0,
				0,0,0,24,25,0,0,0,0,0,0,0,0,0,0,0,0,0,0,0,
				0,0,0,0,0,0,0,0,0,0,0,0,0,0,0,0,0,0,0,0,
				0,0,0,0,0,0,0,0,0,0,0,0,0,0,0,0,0,0,0,0,
				0,0,0,0,0,0,0,0,0,0,0,0,0,0,0,0,0,0,0,0,
				0,24,25,0,0,0,0,0,0,0,0,0,0,0,0,0,0,0,0,0,
				0,0,0,0,0,0,0,0,0,0,0,0,0,0,0,0,0,0,0,0,
				0,2,2,2,2,1,0,11,12,0,0,0,0,0,0,0,0,0,0,0,
				0,2,2,2,2,1,16,13,14,0,0,0,0,0,0,0,0,0,0,0,
				0,2,2,2,2,1,0,0,0,0,0,0,0,0,0,0,0,0,0,0,
				0,0,0,0,0,0,0,0,0,0,0,0,0,0,0,0,0,0,0,0,
				0,0,0,0,0,0,0,0,0,0,0,0,0,0,0,0,0,0,0,0,
				0,0,0,0,0,0,0,0,0,0,0,0,0,0,0,0,0,0,0,0
			],
			"attr" : [
				1,1,1,1,1,1,1,1,1,1,1,1,1,1,1,1,1,1,1,1,
				1,0,0,0,0,0,0,0,0,0,0,0,0,0,0,0,0,0,0,1,
				1,0,0,0,0,0,0,0,0,0,0,0,0,0,0,0,0,0,0,1,
				1,0,0,0,0,0,0,0,0,0,0,0,0,0,0,0,0,0,0,1,
				1,0,0,0,0,0,0,0,0,0,0,0,0,0,0,0,0,0,0,1,
				1,0,0,0,0,0,0,0,0,0,0,0,0,0,0,0,0,0,0,1,
				1,0,0,0,0,0,0,0,0,0,0,0,0,0,0,0,0,0,0,1,
				1,0,0,0,0,0,0,0,0,0,0,0,0,0,0,0,0,0,0,1,
				1,0,0,0,0,0,0,0,0,0,0,0,0,0,0,0,0,0,0,1,
				1,0,0,0,0,0,0,0,0,0,0,0,0,0,0,0,0,0,0,1,
				1,0,0,0,0,0,0,0,0,0,0,0,0,0,0,0,0,0,0,1,
				1,0,0,0,0,0,0,0,0,0,0,0,0,0,0,0,0,0,0,1,
				1,0,0,0,0,0,0,0,0,0,0,0,0,0,0,0,0,0,0,1,
				1,0,0,0,0,0,0,0,0,0,0,0,0,0,0,0,0,0,0,1,
				1,1,1,1,1,1,1,1,1,1,1,1,1,1,1,1,1,1,1,1
			],
			"enemies" : [],
			"items" : [],
			"transitions" : []
		}
	]
}