{
	"tileset" : "assets/tilesets/tiles-skull.json",
	"gridsize" : 16,
	"musicId" : 4,
	"rooms": [
		{
			"id" : 0,
			"x" : 0,
			"y" : 0,
			"width" : 30,
			"height" : 15,
			"cameraBounds" : {
				"x" : 0,
				"y" : 0,
				"width" : 30,
				"height" : 15
			},
			"tile" : [
				9,2,3,2,3,2,3,2,3,2,3,2,3,2,3,2,3,2,3,2,3,2,3,2,3,2,3,2,3,9, 
				5,7,28,7,28,7,4,7,28,7,28,7,7,7,7,7,7,7,7,7,7,7,7,7,7,7,7,7,7,5,
				5,30,29,30,29,30,4,15,16,15,16,15,16,15,16,15,16,15,16,15,16,15,16,15,16,15,16,15,16,5,
				5,11,10,11,10,11,4,13,14,13,14,13,14,13,14,13,14,13,14,13,14,13,14,13,14,13,14,13,14,5, 
				5,30,29,30,29,30,4,15,16,15,16,15,16,15,16,15,16,15,16,15,16,15,16,15,16,15,16,15,16,5,
				5,11,10,11,10,11,4,13,14,13,14,13,14,13,14,13,14,13,14,13,14,13,14,13,14,13,14,13,14,5, 
				5,30,29,30,29,30,4,15,16,15,16,15,16,15,16,15,16,15,16,15,16,15,16,15,16,15,16,15,16,5,
				5,11,10,11,10,11,4,13,14,13,14,13,14,13,14,13,14,13,14,13,14,13,14,13,14,13,14,13,14,5, 
				5,2,3,2,3,2,3,2,3,2,3,2,9,15,16,15,16,15,16,15,16,15,16,15,16,15,16,15,16,5,
				5,18,19,20,19,20,19,20,19,20,19,20,5,14,14,13,14,13,14,13,14,13,14,13,14,13,14,13,14,5, 
				5,21,22,21,22,21,22,21,22,21,22,21,5,15,16,15,16,15,16,15,16,15,16,15,16,15,16,15,16,5, 
				5,13,14,13,14,13,14,13,14,13,14,13,5,14,14,13,14,13,14,13,14,13,14,13,14,13,14,13,14,5, 
				5,15,16,15,16,15,16,15,16,15,16,15,9,2,3,2,3,2,3,2,16,15,16,15,16,15,16,15,16,15,
				5,13,14,13,14,13,14,13,14,13,14,13,14,13,14,13,14,13,14,13,14,13,14,13,14,13,14,13,14,13, 
				5,2,3,2,3,2,3,2,3,2,3,2,3,2,3,2,3,2,3,2,3,2,3,2,3,2,3,2,3,2
			],
			"attr" : [
				1,1,1,1,1,1,1,1,1,1,1,1,1,1,1,1,1,1,1,1,1,1,1,1,1,1,1,1,1,33,
				1,0,0,0,0,0,2,0,0,0,0,0,0,0,0,0,0,0,0,0,0,0,0,0,0,0,0,0,0,1,
				1,0,0,0,0,0,2,0,0,0,0,0,0,0,0,0,0,0,0,0,0,0,0,0,0,0,0,0,0,1,
				1,0,0,0,0,0,2,0,0,0,0,0,0,0,0,0,0,0,0,0,0,0,0,0,0,0,0,0,0,1,
				1,0,0,0,0,0,2,0,0,0,0,0,0,0,0,0,0,0,0,0,0,0,0,0,0,0,0,0,0,1,
				1,0,0,0,0,0,130,0,0,0,0,0,0,0,0,0,0,0,0,0,0,0,0,0,0,0,0,0,0,1,
				1,0,0,0,0,0,2,0,0,0,0,0,0,0,0,0,0,0,0,0,0,0,0,0,0,0,0,0,0,1,
				1,0,0,0,0,0,2,0,0,0,0,0,0,0,0,0,0,0,0,0,0,0,0,0,0,0,0,0,0,1,
				1,1,1,0,1,1,1,1,1,1,1,1,33,0,0,0,0,0,0,0,0,0,0,0,0,0,0,0,0,1,
				1,1,1,1,1,1,1,1,1,1,1,1,1,0,0,0,0,0,0,0,0,0,0,0,0,0,0,0,0,1,
				1,1,1,1,1,1,1,1,1,1,1,1,1,0,0,0,0,0,0,0,0,0,0,0,0,0,0,0,0,1,
				1,1,1,1,1,1,1,1,1,1,1,1,1,0,0,0,0,0,0,0,0,0,0,0,0,0,0,0,0,1,
				1,1,1,1,1,1,1,1,1,1,1,1,65,0,0,0,0,0,0,0,0,0,0,0,0,0,0,0,0,0,
				1,1,1,1,1,1,1,1,1,1,1,1,1,0,0,0,0,0,0,0,0,0,0,0,0,0,0,0,0,0,
				1,1,1,1,1,1,1,1,1,1,1,1,1,1,1,1,1,1,1,1,1,1,1,1,1,1,1,1,1,1
			],
			"enemies" : [],
			"items" : [],
			"transitions" : [
				{ 
					"to" : 1,
					"width" : 1,
					"height" : 2,
					"x" : 30,
					"y" : 12,
					"direction" : "forward"
				}
			]
		},
		{
			"id" : 1,
			"x" : 30,
			"y" : 0,
			"width" : 16,
			"height" : 15,
			"cameraBounds" : {
				"x" : 0,
				"y" : 0,
				"width" : 16,
				"height" : 15
			},
			"tile" : [
				9,2,3,2,3,2,3,2,3,2,3,2,3,2,3,9,
				5,0,0,0,0,0,0,0,0,0,0,0,0,0,0,5,
				5,0,0,0,0,0,0,0,0,0,0,0,0,0,0,5,
				5,0,0,0,0,0,0,0,0,0,0,0,0,0,0,5,
				5,0,0,0,9,9,9,0,9,9,0,0,0,0,0,5,
				5,0,0,0,0,0,9,0,0,9,9,9,0,0,0,5,
				5,0,0,0,9,0,0,0,0,0,0,9,0,0,0,5,
				5,0,0,0,9,9,9,9,9,9,9,9,0,0,0,5,
				5,0,0,0,0,0,0,0,0,0,0,0,0,0,0,5,
				5,0,0,0,0,0,0,0,0,0,0,0,0,0,0,5,
				5,0,0,0,0,0,0,0,0,0,0,0,0,0,0,5,
				5,0,0,0,0,0,0,0,0,0,0,0,0,0,0,5,
				0,0,0,0,0,0,0,0,0,0,0,0,0,0,0,5,
				0,0,0,0,0,0,0,0,0,0,0,0,0,0,0,5,
				3,2,3,2,9,0,0,0,0,9,3,2,3,2,3,9
			],
			"attr" : [
				1,1,1,1,1,1,1,1,1,1,1,1,1,1,1,1,
				1,0,0,0,0,0,0,0,0,0,0,0,0,0,0,1,
				1,0,0,0,0,0,0,0,0,0,0,0,0,0,0,1,
				1,0,0,0,0,0,0,0,0,0,0,0,0,0,0,1,
				1,0,0,0,1,1,1,0,1,1,0,0,0,0,0,1,
				1,0,0,0,0,0,1,0,0,1,1,1,0,0,0,1,
				1,0,0,0,1,0,0,0,0,0,0,1,0,0,0,1,
				1,0,0,0,1,1,1,1,1,1,1,1,0,0,0,1,
				1,0,0,0,0,0,0,0,0,0,0,0,0,0,0,1,
				1,0,0,0,0,0,0,0,0,0,0,0,0,0,0,1,
				1,0,0,0,0,0,0,0,0,0,0,0,0,0,0,1,
				1,0,0,0,0,0,0,0,0,0,0,0,0,0,0,1,
				0,0,0,0,0,0,0,0,0,0,0,0,0,0,0,1,
				0,0,0,0,0,0,0,0,0,0,0,0,0,0,0,1,
				1,1,1,1,1,0,0,0,0,1,1,1,1,1,1,1
			],
			"enemies" : [],
			"items" : [],
			"transitions" : [
				{ 
					"to" : 0,
					"width" : 1,
					"height" : 2,
					"x" : -1,
					"y" : 12,
					"direction" : "backward"
				},
				{
					"to" : 2,
					"width" : 4,
					"height" : 1,
					"x" : 5,
					"y" : 15,
					"direction" : "down"
				}
			]
		},
		{
			"id" : 2,
			"x" : 30,
			"y" : 15,
			"width" : 17,
			"height" : 15,
			"cameraBounds" : {
				"x" : 0,
				"y" : 0,
				"width" : 17,
				"height" : 15
			},
			"tile" : [
				9,2,3,2,3,0,0,0,0,2,3,2,3,2,3,2,9,
				5,0,0,0,5,0,0,0,0,5,0,0,0,0,0,0,5,
				5,0,0,0,5,0,0,0,0,5,0,0,0,0,0,0,5,
				5,0,0,0,5,0,0,0,0,5,0,0,0,0,0,0,5,
				5,0,0,0,5,0,0,0,0,5,0,0,0,0,0,0,5,
				5,0,0,0,5,0,0,0,0,5,0,0,0,0,0,0,5,
				5,0,0,0,5,0,0,0,0,5,0,0,0,0,0,0,5,
				5,0,0,0,0,0,0,0,0,0,0,0,0,0,0,0,5,
				5,0,0,0,0,0,0,0,0,0,0,0,0,0,0,0,5,
				5,0,0,0,0,0,0,0,0,0,0,0,0,0,0,0,5,
				5,0,0,0,0,0,0,0,0,0,0,0,0,0,0,0,5,
				5,0,0,0,0,0,0,0,0,0,0,0,0,0,0,0,5,
				5,0,0,0,0,0,0,0,0,0,0,0,0,0,0,0,5,
				5,0,0,0,0,0,0,0,0,0,0,0,0,0,0,0,5,
				9,2,3,2,3,2,3,2,3,2,3,2,3,2,3,2,9
			],
			"attr" : [
				1,1,1,1,1,0,0,0,0,1,1,1,1,1,1,1,1,
				1,0,0,0,1,0,0,0,0,1,0,0,0,0,0,0,1,
				1,0,0,0,1,0,0,0,0,1,0,0,0,0,0,0,1,
				1,0,0,0,1,0,0,0,0,1,0,0,0,0,0,0,1,
				1,0,0,0,1,0,0,0,0,1,0,0,0,0,0,0,1,
				1,0,0,0,1,0,0,0,0,1,0,0,0,0,0,0,1,
				1,0,0,0,1,0,0,0,0,1,0,0,0,0,0,0,1,
				1,0,0,0,0,0,0,0,0,0,0,0,0,0,0,0,1,
				1,0,0,0,0,0,0,0,0,0,0,0,0,0,0,0,1,
				1,0,0,0,0,0,0,0,0,0,0,0,0,0,0,0,1,
				1,0,0,0,0,0,0,0,0,0,0,0,0,0,0,0,1,
				1,0,0,0,0,0,0,0,0,0,0,0,0,0,0,0,1,
				1,0,0,0,0,0,0,0,0,0,0,0,0,0,0,0,1,
				1,0,0,0,0,0,0,0,0,0,0,0,0,0,0,0,1,
				1,1,1,1,1,1,1,1,1,1,1,1,1,1,1,1,1
			],
			"enemies" : [],
			"items" : [],
			"transitions" : [
				{ 
					"to" : 1,
					"width" : 4,
					"height" : 1,
					"x" : 5,
					"y" : -1,
					"direction" : "up"
				}
			]
		}
	]
}